7 7 35 0
S 7 7 4 4 5 3
3 1 3 7 0 2 5
6 6 1 4 4 3 3
1 7 5 7 1 6 4
3 5 7 6 0 6 3
6 6 5 2 2 1 3
0 3 7 3 5 3 G