7 8 19 0
-1 0 0 0 -1 -1 -1 -1
-1 0 -1 0 -1 0 0 0
-1 0 -1 0 -1 0 -1 0
S 0 14 0 0 0 0 G
-1 0 -1 -1 -1 0 -1 0
-1 0 8 0 0 0 -1 0
-1 0 4 0 0 0 0 0